******************************
*############################*
*############################*
**###########################*
***##########################*
*****###############******###*
*#####################***####*
*#####################***####*
*###########****########***##*
*#######################*####*
*####**#################*####*
*####***################*####*
*####******#############*####*
*#####################***####*
*############################*
*############################*
*############***#############*
*########********############*
*########**********##########*
************####**************
******************************
******************************
******************************