****************************************************************************
*##########################################################################*
*##########################################################################*
*##########################################################################*
*##########################################################################*
*##########################################################################*
*##########################################################################*
*##########################################################################*
*##########################################################################*
*##########################################################################*
*##########################################################################*
*##########################################################################*
*########*************#####################################################*
*#########*************####################################################*
*##########*************###################################################*
*####################****##################################################*
*#####################****#################################################*
*######################****################################################*
*#######################****###############################################*
*########################****##############################################*
*#########################****#############################################*
*##########################****############################################*
*###########################****###########################################*
*############################****##########################################*
*#############################****#########################################*
*##############################****########################################*
*###############################****#######################################*
*################################***#######################################*
*#####################################**********###########################*
****#######################################################################*
*****######################################################################*
*################################################************##############*
*##########################################################################*
*##########################################################################*
*********########################################################***********
********###################################################################*
*###########****#################################*************#############*
*###########*******########################################################*
*################################*************#############################*
*##########################################################################*
*##########################################################################*
*#####################*******##############################################*
*####################*********#############################################*
*###################***********############################################*
****************************************************************************
