##############################
##############################
##############################
##############################
##############################
##############################
##############################
##############################
##############################
##############################
##############################
##############################
##############################
##############################
##############################
*###########*######***********
*########*********************
*############*****************
*############################*
*############################*
*############################*
******************************
