##############################
##############################
##############################
##############################
##############################
####################******####
######################***#####
######################***#####
############*#**########***###
########################*#####
#####**#################*#####
#####***################*#####
#####******#############*#####
######################***#####
##############################
##############################
#############***##############
#########********#############
#########***####***###########
************######************
##############################
##############################
